NO assets/texturas/color_marble.xpm
SO assets/texturas/color_stone.xpm
WE assets/texturas/color_tiles_2.xpm
EA assets/texturas/color_tiles.xpm

F 10,12,15
C 45,50,60

1111111111111111111111111111111
1000000000000000000000000000001
1000000000000000000000000000001
1000000000000000000000000000001
1000011110000000000000111100001
10000111100000N0000000111100001
1000011110000000000000111100001
1000000000000000000000000000001
1000000000000000000000000000001
1000000000000000000000000000001
1000011110000000000000111100001
1000011110000000000000111100001
1000011110000000000000111100001
1000000000000000000000000000001
1000000000000000000000000000001
1000000000000000000000000000001
1111111111111111111111111111111
